C 225,30,0
WE ./path_to_the_west_texture
SO ./path_to_the_south_texture
NO ./path_to_the_north_texture
F 220,100,0


EA ./path_to_the_east_texture


        1111111111111111111111111
        1000000000110000000000001
        1011000001110000000000001
        1001000000000000000000001
111111111011000001110000000000001
10000000011000000010111101111111
11110111111111011100000010001
11110111111111011101010010001
11000000110101011100000010001
1110111100W0000011000000100011
10011 10000000110101001011111011
1110111111010101111101111000111
11110111 1110101 101111010001
11111111111111111111111111111