NO      ./imgs/north.xpm
EA   	./imgs/east.xpm
SO 	./imgs/south.xpm
WE  	./imgs/west.xpm

C 135,206,235
F 34,100,34

        1111111111111111111111111
        10E000000011000000000001
        101100000111000000000001
        1001000000D00000000000001
111111111011000001110000000000001
10000000001000000010111101111111
11110111111111D11100000010001
11110111111111011101010010001
11000000110101011100000010001
111011110000000011000000100011
10011 10000000110101001011111011
1110111111010101111101111000111
11110111 1110101 101111010001
11111111111111111111111111111
