NO      ./imgs/north.xpm
EA   	./imgs/east.xpm
SO 	./imgs/south.xpm
WE  	./imgs/west.xpm

C 128,183,255
F 127,140,26

        1111111111111111111111111
        10E000000011000000000001
        101100000111000000000001
        1001000000D00000000000001
111111111011000001110000000000001
10000000001000000010111101111111
11110111111111D11100000000001
1111011111111101110010010001
11000000010101011100000010001
11101111000000011000000100011
10011 10000000000001001011111011
1110111111010101111101111000111
11110111 1000101 101111010001
11111111111111111111111111111
