NO      ./imgs/north.xpm
EA   	./imgs/south.xpm
SO 	./imgs/east.xpm
WE  	./imgs/west.xpm

F       0,128,0
C       135,206,235

        1111111111111111111111111
        1000000000011000000000001
        1011000011100000F0000001
        10010N0F00D0000000000001
111111111011000001110000000000001
100000000010000000101111D1111111
11110111111111D11100000000001
1111D11111111101110010010001
10000000010101011100000010001
11101111000010011000000100011
10001000000100000001000D011111111
11001D1111010101111101111000111
11100011 1000101 101111010001
11111111111111111111111111111
