
NO      ./imgs/9.xpm
SO 	./imgs/10.xpm
EA  	./imgs/8.xpm
WE  	./imgs/12.xpm

C       50,50,50
F       72,60,50


        1111111111111111111111111
        1000000000FF00000000000011111111
        1000000000FF000000000000000000001
        1000000000FF000000000000000000001
        101100000FFF000000000000000000001
        1001000000D0000000E00000000000001
11111111101100000FFF000000000000000000001
10000000001100000FFF000000000000000000001
10111111101100000FFF000000000000000000001
10000000001100000FFFDFFFFFFFF111111111111
111F0F11111FFFDFFF000000F00000000000000001
111FDF1111111F0F11010000100000000000000001
1100000011010F0F11000000000F00000000000001
10000000000000001100000000000000F000000001
10000000000000001101010000000000F000011111
100F0001110FDF011111011FF11D1111111111111
100F0001 1110101 101111000001
100F0001 11FDF11 111100000111
1100000111100011111FFF0000011
1111000D000000000D00000000011
11111111111111111111111111111