
NO      ./imgs/9.xpm
SO 	./imgs/10.xpm
EA  	./imgs/8.xpm
WE  	./imgs/12.xpm

C       50,50,50
F       72,60,50


        1111111111111111111111111
        1000000000FF0000000000001
        101100000FFF0000000000001
        1001000000D0000000W000001
11111111101100000FFF0000000000001
10000D00001100000111D111111111111
111F0F11111FFFDFFF000000F0001
111FDF1111111F0F1101010000001
1100000011010F0F11000000F0001
100000000000000011000000F0001
100000000000000011010100F0001
100F0001110FDF01111101111000111
100F0001 1110101 101111000001
100F0001 11FDF11 111100000111
1100000111100011111FFF0000011
1111000D000000000D00000000011
11111111111111111111111111111