
EA  	./imgs/south.xpm
WE  	./imgs/west.xpm
SO 	./imgs/east.xpm
NO ./imgs/north.xpm

C       135,206,230
F       50,66,10




11111111111111111111
10000000000000010001
10000000010000010001
10000000000000010001
10000000000000000001
10000000000000010001
10000000000000011111
10000000000E000D0001
11111111111111111111