
NO ./imgs/9.xpm
SO 	./imgs/10.xpm
EA  	./imgs/8.xpm
WE  	./imgs/12.xpm

C       50,50,50
F       72,60,50




11111111111111111111
10000000000000010001
10000000010000010001
10000000000000010001
10000000000000000001
10000000000000010001
10000000000000011111
10000000000N000D0001
11111111111111111111