NO      ./images/jnon1.xpm
EA   	./images/jnon2.xpm
SO 	./images/jnon3.xpm
WE  	./images/jnon4.xpm

C 59, 30, 84
F 212, 190, 228

111111111111111111111111
100000000000000000000001
100000000000000000000001
100000000000000000000001
100000000000E00000000001
100000000000000000000001
100000000000000000000001
100000000000000000000001
100000000000000000000001
111111111111111111111111
