2NO      ./imgs/north2.xpm
EA   	./imgs/east2.xpm
SO 	./imgs/south2.xpm
WE  	./imgs/west2.xpm

F       150,75,0
C       135,206,235

111111111111111111111111111111111
1N0000000000000000000000000000001
101111111011111111111110111111101
100000000010000000000010000000001
101111111010111111111010111111101
100000000010000000000010000000001
101111111011111111111110111111101
100000000000000000000000000000001
101111111111111111111111111111101
100000000000000000000000000000001
101111111011111111111110111111101
100000000010000000000010000000001
101111111010111111111010111111101
100000000010000000000010000000001
101111111011111111111110111111101
100000000000000000000000000000001
111111111111111111111111111111111