NO      ./imgs/north.xpm
EA   	./imgs/east.xpm
SO 	./imgs/south.xpm
WE  	./imgs/west.xpm

C 128,183,255
F 127,140,26

        11111111111111111111111111111111
        100000000000011000000000000000W01
        10110000000000000000000000001111
        1001000000000000000000000000001
11111111101100000000011100000000000011111
100000000010000000000101111000111111
111101111111000111000000000011
1111011111111100110010010001
11000000010101001100000010001
11101111000000001000000100011
100010000000000000010000011111111
1100101111010101111101111000111
11100011 1000101 101111010001
11111111111111111111111111111