NO      ./imgs/north.xpm
EA   	./imgs/east.xpm
SO 	./imgs/south.xpm
WE  	./imgs/west.xpm

F	150,75,1
C	135,206,235

11111111111111111111
10000000000000000001
10000000000000000001
10000000000000000001
1000000E000000000001
10000000000000000001
10000000000000000001
11111111111111111111